SBOOOBOOOBOOO
OBOBOBOBOBOBO
OBOBOBOBOBOBO
OBOBOBOBOBOBO
OBOBOBOBOBOBO
OBOBOBOBOBOBO
OOOOOOOOOOOBF