SBOOOBOOOBOOO
OBOBOBOBOBOBO
OBOBOBOBOBOBO
OBOBOBOBOBOBO
OBOBOBOBOBOBO
OBOBOBOBOBOBO
OOOBOOOBOOOBF